{	
	"100": "IT",
	"103": "LT",
	"104": "LU",
	"105": "LV",
	"107": "MD",
	"108": "MK",
	"109": "MT",
	"110": "NL",
	"111": "NO",
	"112": "PL",
	"113": "PT",
	"114": "RO",
	"115": "RU",
	"116": "RS",
	"117": "SJ",
	"119": "SK",
	"120": "SI",
	"121": "SE",
	"122": "UA",
	"124": "IE",
	"125": "AF",
	"126": "AE",
	"127": "AM",
	"128": "AZ",
	"129": "BD",
	"130": "BH",
	"131": "BN",
	"132": "BT",
	"133": "CN",
	"134": "CY",
	"135": "GE",
	"137": "ID",
	"138": "IN",
	"139": "IR",
	"140": "IQ",
	"141": "IL",
	"142": "JQ",
	"143": "KZ",
	"144": "KG",
	"145": "KH",
	"146": "KR",
	"147": "KW",
	"148": "LA",
	"149": "LB",
	"151": "QA",
	"152": "MM",
	"154": "MY",
	"153": "MN",
	"155": "NP",
	"156": "OM",
	"157": "TW",
	"158": "PH",
	"159": "KP",
	"1": "AR",
	"10": "PE",
	"11": "PY",
	"12": "SR",
	"13": "UY",
	"14": "VE",
	"16": "AU",
	"18": "FJ",
	"161": "QA",
	"162": "SA",
	"164": "SY",
	"165": "TH",
	"166": "TJ",
	"167": "TM",
	"168": "TL",
	"169": "TR",
	"170": "UZ",
	"171": "VN",
	"172": "YE",
	"173": "JP",
	"174": "LK",
	"175": "TW",
	"176": "AO",
	"177": "BI",
	"178": "BJ",
	"179": "BF",
	"180": "BW",
	"181": "CF",
	"182": "",
	"183": "CM",
	"184": "CD",
	"185": "CG",
	"186": "DJ",
	"187": "DZ",
	"188": "EG",
	"189": "ER",
	"190": "ET",
	"191": "GA",
	"192": "GH",
	"193": "GN",
	"194": "GM",
	"195": "GW",
	"196": "CQ",
	"197": "KE",
	"198": "LR",
	"199": "LY",
	"200": "LS",
	"201": "MA",
	"202": "ML",
	"203": "MZ",
	"204": "MR",
	"205": "MW",
	"206": "NA",
	"207": "NG",
	"208": "NG",
	"210": "RW",
	"211": "SD",
	"212": "SN",
	"213": "SL",
	"214": "SO",
	"215": "SZ",
	"216": "TD",
	"217": "TG",
	"218": "TN",
	"219": "TZ",
	"220": "UG",
	"221": "ZA",
	"222": "ZM",
	"223": "ZW",
	"224": "CV",
	"225": "ST",
	"227": "MU",
	"228": "MG",
	"229": "KM",
	"231": "SL",
	"2": "BO",
	"28": "NZ",
	"24": "NC",
	"3": "BR",
	"33": "SB",
	"35": "TO",
	"37": "VU",
	"4": "CL",
	"5": "CO",
	"6": "EC",
	"7": "FK",
	"8": "GF",
	"9": "GY",
	"42": "CW",
	"48": "CA",
	"49": "CR",
	"50": "CU",
	"51": "KY",
	"52": "DM",
	"53": "DO",
	"54": "GP",
	"55": "GD",
	"56": "GL",
	"57": "GT",
	"58": "HN",
	"59": "HT",
	"60": "JM",
	"62": "LC",
	"63": "MX",
	"65": "MQ",
	"66": "NI",
	"67": "PA",
	"68": "PR",
	"69": "SV",
	"72": "TT",
	"73": "US",
	"74": "VC",
	"75": "VG",
	"79": "AT",
	"80": "BE",
	"81": "BG",
	"82": "BA",
	"83": "BY",
	"84": "CH",
	"85": "CZ",
	"86":  "DE",
	"87": "DK",
	"88":  "ES",
	"89": "EE",
	"90": "FI",
	"91":  "FR",
	"92": "IS",
	"93":  "UK",
	"96": "GR",
	"97": "HR",
	"98": "HU",
	"99": "UE"
}
