{	
	"221":  "ZA",
	"200":  "LS",
	"91":  "FR",
	"86":  "DE",
	"93":  "UK",
	"88":  "ES",
	"113": "PT",
	"100": "IT",
	"96": "GR",
	"99": "UE",
	"169": "TR",
	"188": "EG",
	"138": "IN",
	"16": "AU",
	"28": "NZ",
	"115": "RU",
	"4": "CL",
	"110": "NL",
	"80": "BE",
	"79": "AT",
	"84": "CH",
	"73": "US",
	"63": "MX",
	"3": "BR",
	"48": "CA",
	"219": "TZ",
	"203": "MZ",
	"197": "KE",
	"192": "GH",
	"112": "PL",
	"85": "CZ",
	"98": "HU",
	"158": "PH",
	"133": "CN",
	"173": "JP",
	"151": "QA",
	"228": "MG",
	"199": "LY",
	"187": "DZ",
	"218": "TN",
	"162": "SA",
	"172": "YE",
	"206": "NA",
	"180": "BW",
	"223": "ZW",
	"215": "SZ",
	"205": "MW",
	"176": "AO",
	"222": "ZM",
	"184": "CD",
	"185": "CG",
	"196": "CQ",
	"183": "CM",
	"174": "LK",
	"137": "ID"
}
